width 20
height 15
70.0 70.0 50.0 24.0 45.0 40.0 40.0 40.0
0 0 0 0 0 0 0 0 0 0 0 0 0 0 0 0 0 0 0 0
5 0 0 0 0 0 0 0 0 0 0 0 0 0 0 0 0 0 0 0
0 0 0 0 0 0 0 0 0 0 0 0 0 0 2 0 0 0 0 0
0 0 0 0 0 0 0 0 0 0 0 6 0 2 0 0 0 8 7 0
0 0 0 0 0 0 7 0 0 0 0 0 0 2 0 0 0 0 0 0
0 0 0 0 0 0 0 0 0 0 0 2 0 2 1 1 2 2 3 2
0 0 0 0 0 0 0 0 7 0 0 0 0 2 0 7 2 0 0 0
0 0 0 0 0 0 0 6 0 1 0 0 0 2 0 0 2 0 0 8
0 0 0 0 0 0 0 0 0 0 0 0 0 2 3 2 2 1 1 1
0 0 0 0 0 0 0 2 0 0 0 0 0 2 0 0 0 0 0 0
0 0 0 0 0 0 0 0 0 0 0 0 0 2 0 0 0 0 0 0
0 0 0 0 0 1 0 0 0 0 0 0 0 2 0 0 8 0 0 8
0 0 0 0 0 0 0 0 0 0 0 0 0 2 1 1 1 1 1 1
0 0 0 1 0 0 0 0 0 0 0 0 0 2 0 0 0 0 0 0
2 2 2 2 0 0 0 0 0 0 0 0 0 2 0 0 0 0 0 4

