width 12
height 10
50.0 50.0 50.0 24.0 50.0 43.0
0 0 0 0 0 0 0 0 0 0 0 0
0 0 0 0 0 0 0 0 0 0 0 0
0 5 0 0 0 0 0 0 8 0 0 0
2 2 2 2 2 2 2 2 2 3 2 2
0 0 0 0 0 0 0 0 0 0 0 0
0 0 4 2 2 2 0 0 0 0 0 0
0 0 0 0 0 0 0 0 0 2 2 2
0 0 0 0 7 0 0 0 0 0 0 0
0 1 0 0 0 1 0 0 0 0 0 0
1 1 1 1 1 1 1 0 1 1 1 1

