width 20
height 15
40.0 40.0 30.0 14.4 50.0 43.0 35.0 40.0
0 0 0 0 0 0 0 0 0 0 0 0 0 0 0 0 0 0 0 0
0 0 0 0 0 0 0 0 0 0 0 0 0 0 0 0 0 0 0 0
0 0 0 0 0 0 2 2 2 3 2 2 2 0 0 0 0 0 0 0
0 0 0 0 0 0 2 0 0 0 0 0 2 0 0 0 0 0 0 0
1 1 1 1 0 0 2 0 0 4 0 0 2 0 0 0 0 0 0 0
0 0 0 0 0 2 2 2 2 2 2 2 2 4 2 2 2 2 0 0
0 0 0 0 0 0 0 0 0 0 0 0 0 0 0 0 0 2 0 0
0 0 0 0 0 0 0 0 0 0 0 0 0 0 0 2 3 0 0 0
7 0 0 0 0 0 0 0 0 0 0 0 0 0 2 0 0 0 0 2
0 0 0 0 0 0 0 0 0 0 0 0 0 2 0 0 0 0 0 2
0 0 0 0 0 0 0 0 0 0 0 0 2 0 6 0 0 0 6 2
0 0 0 0 7 0 0 0 0 0 0 1 1 1 1 1 1 1 1 1
0 0 0 0 0 0 0 0 0 0 0 0 0 0 0 0 0 0 0 0
5 0 0 0 0 0 0 0 0 0 0 0 0 0 0 0 0 0 0 0
2 2 2 0 0 0 0 0 0 0 0 0 0 0 0 0 0 0 0 0
