width 12
height 9
0 0 0 0 0 0 0 0 0 0 0 0
0 5 0 0 0 8 0 0 6 0 0 0
2 2 2 2 2 2 2 2 2 3 2 2
0 0 0 0 6 0 0 0 0 0 0 0
0 0 0 2 2 2 0 0 0 0 7
0 0 0 0 0 0 0 0 0 2 2 2 
0 7 1 0 6 1 0 0 0 0 0 0
1 1 1 1 1 1 1 0 1 1 1 1
4 2 2 2 2 2 2 0 2 2 2 2

