width 20
height 17
25.0 25.0 30.0 20.0 40.0 40.0 35.0 40.0
0 0 0 0 0 0 0 0 0 0 0 0 0 0 0 0 0 0 0 0
0 0 0 0 0 0 0 0 0 0 0 0 0 0 0 0 0 0 8 0
0 0 0 0 0 0 0 2 2 2 2 2 2 2 2 3 3 3 2 2
0 0 0 0 0 0 0 2 0 0 0 0 0 0 0 0 0 0 0 0
0 0 0 0 0 2 0 2 0 0 0 7 0 0 7 0 0 0 0 0
0 0 0 0 0 0 0 2 0 0 0 2 0 0 2 0 0 0 0 0
7 0 0 0 0 0 0 2 0 0 8 2 0 0 2 0 0 0 0 6
0 0 0 0 0 0 0 2 3 1 1 2 1 1 2 1 1 1 1 1
2 0 0 0 0 0 0 2 0 0 0 2 6 6 6 6 6 6 6 6
0 0 0 0 0 0 0 2 0 0 0 2 6 6 6 6 6 6 6 6
0 0 0 7 0 0 0 2 0 0 0 2 2 2 2 2 2 2 2 2
0 0 0 0 0 0 0 2 1 1 3 2 0 0 0 0 0 0 0 0
0 0 0 0 0 2 0 2 0 0 0 2 0 0 0 0 0 0 0 0
0 7 0 0 0 0 0 2 0 0 0 2 0 0 0 0 0 0 0 0
0 0 0 0 0 0 0 2 0 0 0 1 0 0 7 0 0 0 0 0
5 0 0 0 0 0 0 2 0 6 0 1 0 0 0 0 0 0 0 0
2 0 0 0 0 0 0 2 1 1 1 1 1 1 1 0 0 0 0 4

