width 20
height 15
0 0 0 0 0 0 0 0 0 0 0 0 0 0 0 0 0 0 0 0
0 0 0 0 0 0 0 0 0 0 0 0 7 0 0 0 0 0 0 0
5 0 0 0 0 0 0 0 0 0 6 0 0 0 0 0 0 0 0 0
3 1 0 0 1 0 0 2 2 1 1 1 1 1 1 1 1 2 1 1
0 0 0 0 0 0 0 2 2 0 0 0 0 0 0 0 0 0 0 0
0 0 0 0 0 0 0 2 2 0 0 0 0 0 0 0 0 0 0 0
3 2 2 2 2 2 2 2 2 2 2 2 2 2 0 0 0 0 2 4
0 0 0 0 0 0 0 0 0 0 0 0 0 0 0 0 0 2 0 0
0 0 0 0 0 0 0 0 0 0 0 0 0 0 0 0 2 0 0 0
3 1 1 1 1 1 1 1 1 1 0 0 0 2 1 1 2 1 1 1
0 0 0 0 0 0 0 0 0 0 0 0 2 0 0 0 0 0 0 0
0 0 0 0 0 0 0 0 0 0 0 2 0 0 0 0 0 0 0 0
3 2 2 2 2 2 2 2 2 2 2 1 1 1 1 1 1 1 1 1
0 0 0 0 0 0 0 0 0 0 0 0 0 0 0 0 0 0 0 0
4 1 1 1 1 1 1 1 1 1 1 1 1 1 1 1 1 1 1 1



